#######################
#..........#..........#
#.###.####.#.####.###.#
#.###.####.#.####.###.#
#..........1..........#
#.###.#.#######.#.###.#
#.....#.#######.#.....#
#####.#....#....#.#####
#####.#### # ####.#####
#####.#         #.#####
#####.# ### ### #.#####
     .  #     #  .     
#####.# #     # #.#####
#####.# ####### #.#####
#####.#         #.#####
#####.###########.#####
#..........#..........#
#.###.####.#.####.###.#
#...#.............#...#
###.#.#.#######.#.#.###
#.....#....#....#.....#
#.########.#.########.#
#.########.#.########.#
#.....................#
#######################