11111111111111111111111111
00000000000000000000000000
11100011010000000000000000
10000000011000000000000000
10011101011010010101000000
00000000001111111111000000